1111111111111
10000PECCC01
100000000001
100000000001
111111111111
