111111111111111111
1000000PECCCC00001
100000011000000001
111111111111111111
