111111111111111111
1000000PECCCC00001
111111111111111111
