111111111111111111
1000000PECCCC00001
100000001000000001
111111111111111111
